1111111111111
1010001000101
1010101011101
1000101000101
1011101011101
1000100000001
1111101110111
1000000010001
1010111010101
1010001010101
1010111110101
1010000010101
1111111111111
